G G Y G Y G Y G G
G G G G G G G G G
G G R G G G G G G
G G G G G G G G G
G G G R R R G G G
G G G G G G G G G
G G G G G G G G G
G G G G T G G G G
G G G G R G G G G